**************************************************
*S************************************************
*                                  ***************
* **** ***** ****************** ** **         ****
* ********** **************** * ** ** *******    *
*E**********               ** * ** ** **** ** ** *
* ************************ ** **** ** **** ** ** *
* *********            *** ** **** ** **** ** ** *
* ********* * ****** ***    ****** ***** ** ** * *
* ********* * ******************** **      ** ** *
*         * * ********             ********** ** *
********************** ********************** ** *
**                                            ** *
** ********************************************* *
** ***                                      **** *
** *** ************************************ *    *
** *** **             ****    ***        ** **** *
** *** ** **** ** *** **** ** *** ********* **** *
** *** ** **** ** ***      **               ******
**     ** ****************************************
*********                                       **
*************** ************************ ****** **
*********************************************** **
*                                               **
* *** ********************************************
* *** ***            *                        ****
* *** *** ********** * **************** ***** ****
* *** *** ********** * ****  ***     ** **  *   **
* *** *** ***    *** * ***** *** *** ** ** ** * **
* *** *** *** ** *** *       *** *** ** ** ** * **
* *** *** *** **     * *** ***** *** **    ** * **
*  **     *** ******** ***    ** *** ** ***** * **
* ***********          ********* *** **   *** * **
******************************** *** ******** * **
***                              ***          * **
* * ******************************************* **
* * **********************************************
* * ***                                         **
* * *** *************************************** **
* * *** **                  ******************* **
* * *** ** * ********************************** **
* * *** ** * *                                  **
* * *** ** * * ***********************************
* * *** ** * *   **     ** ****** *** ************
* * *** ** * * * ** *** ** ****** *** ***       **
* * *** ** * * * ** **                  * ***** **
* * *** ** *** *    ****** ***** ****** * ***** **
* * ***    *** ************************** ***** **
* * *** ******                            ***** **
*       *************************************** **
***********************************************E**
**************************************************